TCGA-AO-A03M	Infiltrating Ductal Carcinoma
TCGA-AO-A03V	Infiltrating Ductal Carcinoma
TCGA-AO-A0J8	Infiltrating Lobular Carcinoma
TCGA-AO-A0J9	Infiltrating Lobular Carcinoma
TCGA-AO-A0JB	Infiltrating Ductal Carcinoma
TCGA-AO-A0JF	Infiltrating Ductal Carcinoma
TCGA-AO-A0JI	Infiltrating Ductal Carcinoma
TCGA-AO-A0JM	Infiltrating Ductal Carcinoma
TCGA-AO-A129	Infiltrating Ductal Carcinoma
TCGA-AO-A12D	Infiltrating Ductal Carcinoma
TCGA-AO-A12E	Infiltrating Lobular Carcinoma
TCGA-AO-A12F	Infiltrating Ductal Carcinoma
TCGA-AO-A12G	Other, specify
TCGA-AQ-A04H	Infiltrating Ductal Carcinoma
TCGA-AR-A1AN	Infiltrating Ductal Carcinoma
TCGA-AR-A1AQ	Infiltrating Ductal Carcinoma
TCGA-AR-A1AX	Infiltrating Ductal Carcinoma
TCGA-AR-A24M	Mixed Histology (please specify)
TCGA-AR-A24R	Infiltrating Ductal Carcinoma
TCGA-AR-A24S	Infiltrating Ductal Carcinoma
TCGA-AR-A24U	Infiltrating Ductal Carcinoma
TCGA-AR-A24W	Infiltrating Ductal Carcinoma
TCGA-AR-A24X	Mixed Histology (please specify)
TCGA-AR-A254	Infiltrating Ductal Carcinoma
TCGA-BH-A0AW	Infiltrating Ductal Carcinoma
TCGA-BH-A0AZ	Infiltrating Ductal Carcinoma
TCGA-BH-A0B1	Infiltrating Ductal Carcinoma
TCGA-BH-A0B3	Infiltrating Ductal Carcinoma
TCGA-BH-A0B5	Infiltrating Lobular Carcinoma
TCGA-BH-A0B6	Infiltrating Ductal Carcinoma
TCGA-BH-A0BG	Infiltrating Ductal Carcinoma
TCGA-BH-A0BJ	Infiltrating Ductal Carcinoma
TCGA-BH-A0BM	Infiltrating Ductal Carcinoma
TCGA-BH-A0BQ	Infiltrating Ductal Carcinoma
TCGA-BH-A0BT	Infiltrating Ductal Carcinoma
TCGA-BH-A0C0	Infiltrating Ductal Carcinoma
TCGA-BH-A0DE	Infiltrating Ductal Carcinoma
TCGA-BH-A0DG	Infiltrating Ductal Carcinoma
TCGA-BH-A0DH	Infiltrating Ductal Carcinoma
TCGA-BH-A0DI	Infiltrating Ductal Carcinoma
TCGA-BH-A0DK	Infiltrating Ductal Carcinoma
TCGA-BH-A0DT	Infiltrating Ductal Carcinoma
TCGA-BH-A0DV	Infiltrating Ductal Carcinoma
TCGA-BH-A0DX	Infiltrating Ductal Carcinoma
TCGA-BH-A0DZ	Infiltrating Ductal Carcinoma
TCGA-BH-A0E0	Infiltrating Ductal Carcinoma
TCGA-BH-A0E1	Infiltrating Ductal Carcinoma
TCGA-BH-A0E2	Infiltrating Ductal Carcinoma
TCGA-BH-A0E9	Infiltrating Lobular Carcinoma
TCGA-BH-A0EI	Infiltrating Ductal Carcinoma
TCGA-BH-A0GY	Infiltrating Ductal Carcinoma
TCGA-BH-A0GZ	Infiltrating Ductal Carcinoma
TCGA-BH-A0H3	Infiltrating Ductal Carcinoma
TCGA-BH-A0H5	Infiltrating Ductal Carcinoma
TCGA-BH-A0H6	Infiltrating Ductal Carcinoma
TCGA-BH-A0H7	Infiltrating Ductal Carcinoma
TCGA-BH-A0H9	Infiltrating Ductal Carcinoma
TCGA-BH-A0HA	Infiltrating Ductal Carcinoma
TCGA-BH-A0HI	Infiltrating Ductal Carcinoma
TCGA-BH-A0HX	Infiltrating Ductal Carcinoma
TCGA-BH-A0HY	Infiltrating Ductal Carcinoma
TCGA-BH-A0RX	Infiltrating Ductal Carcinoma
TCGA-BH-A0W3	Infiltrating Ductal Carcinoma
TCGA-BH-A0W5	Infiltrating Ductal Carcinoma
TCGA-BH-A18F	Infiltrating Ductal Carcinoma
TCGA-BH-A18H	Infiltrating Ductal Carcinoma
TCGA-BH-A18I	Infiltrating Ductal Carcinoma
TCGA-BH-A201	Infiltrating Ductal Carcinoma
TCGA-BH-A202	Infiltrating Ductal Carcinoma
TCGA-BH-A28Q	Infiltrating Lobular Carcinoma
TCGA-E2-A105	Infiltrating Ductal Carcinoma
TCGA-E2-A107	Infiltrating Lobular Carcinoma
TCGA-E2-A108	Infiltrating Ductal Carcinoma
TCGA-E2-A109	Infiltrating Ductal Carcinoma
TCGA-E2-A10F	Infiltrating Lobular Carcinoma
TCGA-E2-A14N	Infiltrating Ductal Carcinoma
TCGA-E2-A14P	Infiltrating Ductal Carcinoma
TCGA-E2-A14Q	Infiltrating Ductal Carcinoma
TCGA-E2-A14S	Infiltrating Ductal Carcinoma
TCGA-E2-A14T	Infiltrating Ductal Carcinoma
TCGA-E2-A14V	Infiltrating Ductal Carcinoma
TCGA-E2-A14X	Infiltrating Ductal Carcinoma
TCGA-E2-A14Y	Infiltrating Ductal Carcinoma
TCGA-E2-A14Z	Infiltrating Ductal Carcinoma
TCGA-E2-A150	Infiltrating Ductal Carcinoma
TCGA-E2-A152	Infiltrating Ductal Carcinoma
TCGA-E2-A159	Infiltrating Ductal Carcinoma
TCGA-E2-A15A	Infiltrating Ductal Carcinoma
TCGA-E2-A15E	Infiltrating Ductal Carcinoma
TCGA-E2-A15F	Infiltrating Ductal Carcinoma
TCGA-E2-A15H	Infiltrating Ductal Carcinoma
TCGA-E2-A15I	Infiltrating Ductal Carcinoma
TCGA-E2-A15J	Infiltrating Ductal Carcinoma
TCGA-E2-A15K	Infiltrating Ductal Carcinoma
TCGA-E2-A15L	Infiltrating Lobular Carcinoma
TCGA-E2-A15M	Infiltrating Lobular Carcinoma
TCGA-E2-A1B1	Infiltrating Ductal Carcinoma
TCGA-E2-A1B5	Infiltrating Lobular Carcinoma
TCGA-E2-A1B6	Infiltrating Ductal Carcinoma
TCGA-E2-A1IE	Infiltrating Ductal Carcinoma
TCGA-E2-A1IG	Infiltrating Ductal Carcinoma
TCGA-E2-A1II	Infiltrating Ductal Carcinoma
TCGA-E2-A1IJ	Infiltrating Lobular Carcinoma
TCGA-E2-A1IK	Infiltrating Ductal Carcinoma
TCGA-E2-A1IN	Infiltrating Ductal Carcinoma
TCGA-E2-A1L7	Infiltrating Ductal Carcinoma
TCGA-E2-A1L9	Infiltrating Ductal Carcinoma
TCGA-E2-A1LG	Infiltrating Lobular Carcinoma
TCGA-EW-A1IY	Infiltrating Ductal Carcinoma
TCGA-EW-A1IZ	Infiltrating Ductal Carcinoma
TCGA-EW-A1J2	Infiltrating Lobular Carcinoma
TCGA-EW-A1J6	Infiltrating Ductal Carcinoma
TCGA-EW-A1OY	Infiltrating Ductal Carcinoma
TCGA-EW-A1OZ	Infiltrating Ductal Carcinoma
TCGA-EW-A1P0	Other, specify
TCGA-EW-A1P3	Infiltrating Ductal Carcinoma
TCGA-EW-A1P4	Medullary Carcinoma
TCGA-EW-A1PA	Infiltrating Ductal Carcinoma
TCGA-EW-A1PC	Infiltrating Ductal Carcinoma
TCGA-EW-A2FR	Infiltrating Ductal Carcinoma
TCGA-EW-A2FS	Infiltrating Ductal Carcinoma
TCGA-EW-A3E8	Infiltrating Lobular Carcinoma
TCGA-EW-A423	Infiltrating Lobular Carcinoma
TCGA-OL-A5D6	Infiltrating Ductal Carcinoma
TCGA-OL-A5D7	Infiltrating Ductal Carcinoma
TCGA-OL-A5D8	Infiltrating Ductal Carcinoma
TCGA-OL-A5DA	Infiltrating Lobular Carcinoma
TCGA-OL-A5RU	Infiltrating Ductal Carcinoma
TCGA-OL-A5RV	Infiltrating Ductal Carcinoma
TCGA-OL-A5RW	Infiltrating Ductal Carcinoma
TCGA-OL-A5RX	Infiltrating Ductal Carcinoma
TCGA-OL-A5RZ	Infiltrating Ductal Carcinoma
TCGA-OL-A66I	Infiltrating Ductal Carcinoma
TCGA-OL-A66J	Infiltrating Lobular Carcinoma
TCGA-OL-A66K	Infiltrating Lobular Carcinoma
TCGA-OL-A66L	Infiltrating Ductal Carcinoma
TCGA-OL-A66N	Infiltrating Lobular Carcinoma
TCGA-OL-A66O	Infiltrating Ductal Carcinoma
TCGA-OL-A6VO	Infiltrating Ductal Carcinoma
TCGA-OL-A6VR	Infiltrating Ductal Carcinoma
